NO textures/simonkraft/respawn_anchor_side0.xpm



EA textures/simonkraft/respawn_anchor_side2.xpm



SO textures/simonkraft/respawn_anchor_side4.xpm



WE textures/simonkraft/respawn_anchor_side3.xpm

C                  878      1,            223,                             

F                                  15,6,40

 11111111111111
111111000111111
111110000011111
11110000001111
111000000000111
11000000000011
1000011111000011111111111
110000111000011
111000010000111
111100000001111
111110000011111
11111100111111
111111111111111