NO ./path_to_the_north_texture


SO ./path_to_the_south_texture



WE ./path_to_the_west_texture



EA ./path_to_the_east_texture

F 220,100,0

C 225,30,0



       1111111111111111111111111111111111111111
       1000000000000000000000000000000000011011
       1000000000000000000000000000000000011011
       1111111111000000000000000000011111100011
11111111000000000000000000000000000000000011111
1000000000000000000000000000000000000000001
1000000000000000000000000000000000000000001
1000000000000000000000000000000000000000001
1000000000000000000000000000000000000000001
10000000000000000000000000000000000000000011111
10000000001  1000000001   10000000000000001
10101001101  1010101001   10001010000100011
11111111111  1111111111   11111111111111111

