           NO textures/wall_textures/image1.xpm   
SO textures/wall_textures/image2.xpm
  EA textures/wall_textures/image4.xpm


C 0, 0, 0



      F 70, 50,40
WE  textures/wall_textures/image3.xpm

111111111111111111111
101000001000000000001
1010101D101111111000111111111111111111111111111111111111
100010100010000010001111111111111111111111111111
1111101011111010111D11111111111111
100000101000101000001
1D1111101010001111111
101000001010100000101
101011111010111110101
101010001010100010101
101110101010101010101
100000101D10001010001
111101101011111011101
100000101000000010001
1D1110101010101110111
101000000000100010101
101011111111111010101
1000D0000E000000D0001
101010111011111111101
101000001000000000001
111111111111111111111


