
NO  textures/wall_textures/image1.xpm
SO  textures/wall_textures/image2.xpm
WE  textures/wall_textures/image3.xpm
EA  textures/wall_textures/image4.xpm

C 210, 190, 140
F 70, 50,40

111111111111111111111
101000001000000000001
101010101011111110001
100010100010000010001
111110101111101011101
100000101000101000001
101111101010001111111
101000001010100000101
101011111010111110101
101010001010100010101
101110101010101010101
100000101010001010001
1111D1101011111011101
100000101000000010001
1D111D101010101110111
101E00000000100010101
101011111111111010101
1000D00000000000D0001
101010111011111111101
101000001000000000001
111111111111111111111

