NO textures/simonkraft/respawn_anchor_side0.xpm



EA textures/simonkraft/respawn_anchor_side2.xpm 



SO textures/simonkraft/respawn_anchor_side4.xpm


WE textures/simonkraft/respawn_anchor_side3.xpm

                         C  0,             2  , 5
                         F                                  15,1,40






        1111111 111 111 111111 1111111
      111111000111111111111
       111110000011111111 11111111
        11110000001111
         11100000000011111111
          110N0000000011     
          100001111100001111111111
          110000111000011
            111000010001111
            11111111111 11111






