NO  textures/0wall.xpm
SO  textures/wall_textures/image2.xpm
WE  textures/wall_textures/image3.xpm
EA  textures/wall_textures/image4.xpm

C 210, 190, 140
F 70, 50,40

111111111111111111111111111111111111111111111111111111111111111
100000000000000000000000000000000000000000000000000000000000001
100000000001010100000000000000000000000000000000000000000000001
100010000000000000000000000000000000000000000000000000000000001
100000000000000000000000000001000000000000000000000000000000001
100010000000000000000000W000000000000000000X0000000000000000001
100000000000000000000000000000000000000000000000000000000000001
100000000000000000000000000000000000000000000000000000000000001
100000000000000000000000000000000000000000000000000000000000001
100000000000000000000000000000000000000000000000000000000000001
100000000000000000000000000000000000000000000000000000000000001
111111111111111111111111111111111111111111111111111111111111111




