C 210, 190, 140
F 70, 50,40
NO  textures/wall_textures/image1.xpm
SO  textures/wall_textures/image2.xpm
WE  textures/wall_textures/image3.xpm
EA  textures/wall_textures/image4.xpm


11111111111111111111111111111111111111111111111111111111111111111111
10000000000000000000000000000000000000000000000000000000000000000001
10000000000101010000000000000100000000000000000000000000000000111111
100010000000000000000000000000000000000000000000000000000000001
100000000000000000010000000000000000000000000000000000000000001
1000100000000000000D00000000000E000000000000000000000000000011
100000000000000000010000000000000000000000000000000000000000001
100000000000000000000000000000000000000000000000000000000000001
100000000000000000111000000000000000000000000000000000000000001
10000000000000000010000000000000000000000000000000000000000001
100000000000000000111000000000000000000000000000000000000000001
111111111111111111111111111111111111111111111111111111111111111




