C 220, 220, 255
F 60, 60, 60

NO  maps/textures/image1.xpm
SO  maps/textures/image2.xpm
WE  maps/textures/image3.xpm
EA  maps/textures/image4.xpm

111111111111111111111111111111111111111111111111111111111111111
100000000000000000000000000000000000000000000000000000000000001
100000000001010100000000000000000000000000000000000000000000001
100010000000000000000000000000000000000000000000000000000000001
100000000000000000000000000001000000000000000000000000000000001
10001000000000W000000000000000000000000000000000000000000000001
100000000000000000000000000000000000000000000000000000000000001
100000000000000000000000000000000000000000000000000000000000001
100000000000000000000000000000000000000000000000000000000000001
100000000000000000000000000000000000000000000000000000000000001
100000000000000000000000000000000000000000000000000000000000001
111111111111111111111111111111111111111111111111111111111111111




